22 55
54 21
  1111   1111     1111     1111   1111   1111    1111    1111     1111   1111    1111     1111    1111    1111    1111   1111     1111     1111    1111   1111     1111    1111     1111    1111    1111    1111     1111    1111    1111     1111    1111    1111    1111    1111     1111     1111    1111     1111   1111   1111   1111     1111    1111    1111     1111   1111     1111   1111   1111   1111     1111   1111     1111     1111   1111
  1111   1111     1111     1111   1111   1111    1111    1111     1111   1111    1111     1111    1111    1111    1111   1111     1F11     1F11    1F11   1F11     1F11    1F11     1F11    1F11    1F11    1111     1D11    1D11    1D11     1D11    1D11    1D11    1D11    1D11     1D11     1D11    1D11     1D11   1D11   1D11   1D11     1D11    1D11    1D11     1D11   1D11     1D11   1D11   1D11   1111     1711   1711     1111     1111   1111
  1111   1111 47CE0000     1111 CE0000 CE0000  CE0000 BCE0000  BCE0000 CE0000 4CE0000   CE0000  CE0000 4CE0000  CE0000   11F1   CE0000 F5CE0000  CE0000 CE0000   CE0000  CE0000   CE0000  CE0000  CE0000    11DF  BBE0000 9BE0000  BE0000 65BE0000  BE0000  BE0000  BE0000  BE0000  4BE0000   BE0000  BE0000  4BE0000 BE0000 BE0000 BE0000  4BE0000  BE0000  BE0000   BE0000 BE0000  4BE0000 BE0000 BE0000   117D   CE0000 CE0000   CE0000 12CE0000   1111
  1111   1111   CE0000     1111 CE0000   1111    1111    1111     1111   1111    1111     1111    1111    1111  CE0000   11F1  BCE0000     F11F    F111   F111     F111    F1B1   CE0000    F1FB  CE0000    1F1F     DF11    DF11    DF11     DFF1  CE0000    D11F    DE11    DE11     DE11     D111    D111     D111   D111   D111   D111     D111    D111    D111     D111   D111     D111   D1D1 BE0000   117D   CE0000   7117   CE0000 11CE0000   1111
  1111   1111  9CE0000     1111 CE0000 CE0000  CE0000    1111  9CE0000   1111 4CE0000   CE0000  CE0000 9CE0000  CE0000   11F1  3CE0000     111F  CE0000 CE0000  4CE0000  CE0000   CE0000    11F1  CE0000  CE0000   CE0000  CE0000  CE0000   CE0000  CE0000    11EF 9CE0000 9CE0000  9CE0000     1115  CE0000   CE0000 CE0000 CE0000 CE0000   CE0000  CE0000  CE0000   CE0000   1111  9CE0000   11D1 BE0000   117D 45CE0000   1117   CE0000   CE0000   1111
  1111   1111  9CE0000     1111   5111   1111  CE0000    1111  9CE0000   1111  CE0000     1111    1111    1111    1111   1111     F111     1111  CE0000   1111     1111    1111     C111    1111    F111    F111     F111    F111    F111     F111    FE11    1EE1 9CE0000    EE1E     EE11     1E11  CE0000     1111   1111   1111   1111     1111  CE0000    1111   CE0000   1111 25CE0000   11D1 BE0000   117D  BCE0000   1117   CE0000   CE0000   1111
  1111   1111   CE0000 F5CE0000 CE0000 CE0000  CE0000    1111   CE0000   1111 4CE0000   CE0000  CE0000  CE0000 9CE0000 CE0000  4CE0000     1111  CE0000   1111   CE0000 4CE0000   CE0000  CE0000 4CE0000    1111  4CE0000  CE0000  CE0000     11E1 BCE0000 BCE0000 4CE0000  CE0000 75CE0000 75CE0000 4CE0000     1111 CE0000 CE0000 CE0000  4CE0000  CE0000    1111   CE0000 CE0000   CE0000   11D1 BE0000   117D  9CE0000   1117   CE0000   CE0000   1111
  1111   1111     1111     1111   1111   1C11    1111    1111 DACE0000   1111    1C11     1111    1111    1111    1111   1111   CE0000     1111  CE0000   1111   CE0000    1111     1111    1111  CE0000    1111   CE0000    1111  CE0000     1111    E111    E1E1 9CE0000    EE1E     EE11     E111    1111     1111 CE0000   1111   1111     1311    1611    1111     1111   1111   CE0000   11D1 BE0000   1D1D     7D11   1111   CE0000   CE0000   1111
  1111   1111  4CE0000   CE0000 CE0000 CE0000 9CE0000 4CE0000   CE0000   11A1  CE0000   CE0000  CE0000  CE0000  CE0000 CE0000  4CE0000     1111  CE0000 CE0000  4CE0000  CE0000  9CE0000    111B  CE0000 4CE0000   CE0000    1111  CE0000  4CE0000  CE0000    11E1 9CE0000 9CE0000  9CE0000     1115  CE0000  4CE0000 CE0000   1111 CE0000  4CE0000 BCE0000    1115   CE0000 CE0000   CE0000   11D1 BE0000 BE0000   BE0000   111D   CE0000   CE0000   1111
  1111   1111   CE0000     1111   1111   C111    1111    1111     1111   1111  CE0000     1111    1111    1111    1111   1111     1111     1111    1111   1111     1111    1111     1C11    1111    1111    1111     1111    1111    1111     1111 9CE0000    111C    E111    E111     E111     1111  CE0000     1111   1111   1111 CE0000     3111    6111    1111  4CE0000   1111     1D11   1D11   DD11   DDD1  9BE0000   111D   CE0000   CE0000   1111
  1111   1151  BCE0000   CE0000 CE0000 CE0000 4CE0000  CE0000   CE0000 CE0000 4CE0000     1111 4CE0000  CE0000 4CE0000   1111   CE0000  4CE0000  CE0000 CE0000  4CE0000  CE0000   CE0000    1111  CE0000 4CE0000   CE0000  CE0000  CE0000  4CE0000  CE0000    1111  CE0000  CE0000   CE0000  4CE0000  CE0000     1111 CE0000 CE0000 CE0000     1111  CE0000  CE0000   CE0000   11D1   BE0000 BE0000 BE0000 BE0000   BE0000   11BD 1ACE0000   CE0000   1111
  1111   1111   CE0000     1111   1111   1111    1111    1111     1111   1111    1111     1111  CE0000    1111  CE0000   1111 95CE0000     1111  CE0000   1111     1B11    1111   CE0000    1111  CE0000    1111     1111    1111    1111     1111    1111    11C1  CE0000    1111     1111     1111    1111     1111 CE0000   1111   1111     1111  CE0000    1111     1111   11D1  4BE0000   D11D   D111   D111     D111   1111   CE0000   CE0000   1111
  1111   1111  4CE0000   CE0000 CE0000 CE0000  CE0000  CE0000  4CE0000   1111 9CE0000 55CE0000  CE0000    1111  CE0000   1111  9CE0000     1111  CE0000   1111   CE0000  CE0000  4CE0000    1111  CE0000    1111  4CE0000 9CE0000 BCE0000     1111  CE0000  CE0000 4CE0000    1111  9CE0000  9CE0000  CE0000 4ACE0000 CE0000   1111 CE0000   CE0000  CE0000 4CE0000  9CE0000   11D1   BE0000   111D CE0000 CE0000   CE0000   1111   CE0000   CE0000   1111
  1111   1111     1111     1111   1111   1C11    1111    1111  9CE0000   1111    1111     1111  CE0000    1111 9CE0000   1111  9CE0000     1111  CE0000   11C1 45CE0000    1111     1111    1111  CE0000    1111  9CE0000    1111    1111     1111  CE0000    11C1  CE0000    1111     1111     1111    1111     1111 CE0000   1111 CE0000     1111    1A11    1111     1D11   1DD1   BE0000   111D CE0000   1111   CE0000   11C1   CE0000   CE0000   1111
  1111   1111  9CE0000     1111 CE0000 CE0000  CE0000    1111   CE0000 CE0000  CE0000   CE0000 4CE0000    1111  CE0000   1111  9CE0000     1111  CE0000   1111   CE0000  CE0000  4CE0000  CE0000 4CE0000    1111 75CE0000    1111  CE0000  4CE0000  CE0000    1111  CE0000    1111   CE0000   CE0000  CE0000     1111 CE0000 CE0000 CE0000     1111 BCE0000    11D1   BE0000 BE0000   BE0000   111D CE0000   1111   CE0000 CE0000   CE0000   CE0000   1111
  1111   1111  9CE0000     1111 CE0000   C111  CE0000    1111     1111   1111    1111     1111    C111    1111  CE0000   1111     1111     1111 4CE0000   1111     B111    1111     1111    1111    1111    1111   CE0000    1111  CE0000     1111    1A11    1111  CE0000    1111   CE0000     1111  CE0000     1111 CE0000   1111   1111     1111 BCE0000    11D1  4BE0000   D11D     D111   1111 CE0000   1111     1511   11C1   CE0000   CE0000   1111
  1111   1111  BCE0000 E5CE0000 CE0000   1111  CE0000  CE0000   CE0000 CE0000  CE0000 65CE0000 BCE0000    1111  CE0000 CE0000  4CE0000     1111 9CE0000   1111   CE0000  CE0000  4CE0000  CE0000  CE0000  CE0000   CE0000 4CE0000  CE0000     1111 9CE0000    1111  CE0000  CE0000   CE0000     1111  CE0000     1111 CE0000 CE0000 CE0000 A5CE0000 4CE0000    11DC   BE0000   111D  9CE0000 CE0000 CE0000   1131  92A0000   1113   CE0000   CE0000   1111
  1111   1111  4CE0000     1111   1511   1111    1111    1111     1C11   1111  CE0000     1111    1111    1B11    1111   1111   CE0000     1111  CE0000   11C1   CE0000    111C     1111    1111    1111    1111     1111    1111    1111     1111  CE0000    1111    1111    1111     1111     1111  CE0000     1111   1211   1211   1211     1111 9CE0000    11D1   BE0000   111D   CE0000   1111   1111   1131  B2A0000   1113   CE0000   CE0000   1111
  1111   1111   CE0000     1111 CE0000 CE0000  CE0000  CE0000   CE0000   111B  CE0000     11C1  CE0000 4CE0000  CE0000   111C   CE0000     1111  CE0000   1111   CE0000  CE0000  4CE0000  CE0000  CE0000  CE0000  4CE0000  CE0000  CE0000     1111  CE0000 4CE0000  CE0000    1111   CE0000   CE0000  CE0000     1141 CE0000 CE0000 CE0000     1112 DCE0000    11D1   BE0000   111D  4CE0000 CE0000 CE0000   1131 552A0000   1113   CE0000   CE0000   1111
  1111   1111   CE0000     1111 CE0000   1111    1111    1111  4CE0000   111B  CE0000     1111  CE0000    1111  CE0000   1111   CE0000     1B11  CE0000   1111     1111    1111     1A11    1111    1111    1111     1111    1111  CE0000     1111    1111    1111  CE0000    111C  4CE0000     1111    1111     1221 CE0000   2122 CE0000     1212    A211    A2D1   BE0000   111D     1111   1111 CE0000   1131  42A0000   1A13   CE0000   CE0000   1111
  1111   1111  BCE0000  4CE0000 CE0000   1111 DCE0000 9CE0000 65CE0000   111B  CE0000   CE0000  CE0000    1111  CE0000 CE0000   CE0000  4CE0000  CE0000   1151  BCE0000 9CE0000  9CE0000 9CE0000 9CE0000 5CE0000  5CE0000 5CE0000  CE0000   CE0000  CE0000 4CE0000  CE0000    1111   CE0000   CE0000  CE0000   CE0000 CE0000   1182 CE0000   CE0000 4CE0000  CE0000 85CE0000 CE0000   CE0000 CE0000 CE0000   11B1   CE0000 CE0000   CE0000   CE0000   1111
  1111   1111     1111     1111   1111   1111    1111    1111     C111   1111    1111     1111    1111    1111    1111   1111     1111     B111    1111   1111     1111    1111     A111    1111    1111    1111     1111    1111    1111     1111    1111    1111    1111    1111     1111     1111    1111     2111   2111   1111   2111     2111    2111    2111     1111   1111     1111   1111   1111   1111     1111   1111     1111     1111   1111